000000000000000
111111111111110
111111111111110
111111111111110
111111111111000